##########
#      # #
## ### # #
## #     #
S  # # # #
# ## ### #
#    # # #
#### # # #
#      # E
##########