#######################################################################################################################################################
S           #                       #                 #           #  #  #  #  #     #  #        #     #              #                 #     #  #     #
####  #############  #  #######  ####  ###################  ####  #  #  #  #  ####  #  #  #  ####  #######  ####  ####  #######  ####  #  ####  ####  #
#     #  #           #     #           #     #  #        #  #              #        #     #  #  #     #  #     #  #     #        #     #  #  #  #  #  #
####  #  #  #  ####  #  #######  #  ####  ####  #  ####  #  #######  #  #  #  #  ####  #######  #  ####  #######  ####  #  ####  ####  #  #  #  #  #  #
#           #  #     #        #  #  #     #        #     #        #  #  #  #  #     #        #  #     #  #  #  #     #  #  #     #  #        #     #  #
#######  #  #  #############  ####  #  #  #######  #  ####  ################  ####  ####  ####  ####  #  #  #  ####  ####  #  ####  #  #######  #  #  #
#  #     #  #  #     #     #     #     #     #  #  #     #  #  #  #           #                    #     #  #  #           #        #  #        #  #  #
#  ####  ####  #  #######  #######  ####  ####  ####  ####  #  #  #######  ######################  #  #  #  #  ################  ####  ##########  #  #
#        #  #  #     #  #  #  #     #  #  #  #  #           #           #  #        #        #  #     #  #  #  #                 #           #        #
#######  #  ####  #  #  #  #  ####  #  #  #  #  ##########  ##########  ####  #  #######  #  #  #  ####  #  #  #######  ####  #############  #######  #
#        #        #        #     #     #  #  #  #        #  #     #        #  #           #        #     #     #  #  #  #        #        #  #  #     #
#  #######  ##########  ####  #######  #  #  #  ####  ####  #  ####  ####  ####  #  #  ####  #  #######  #  ####  #  ####  #  ####  #######  #  ####  #
#  #        #                    #     #     #                       #  #        #  #     #  #     #              #        #           #  #     #     #
#  #  #  ################  #  #  #  #######  #  #######  #######  ####  #  #  #######  ###################  ###################  ####  #  #  #  #  ####
#     #              #     #  #  #        #        #     #  #     #        #        #        #     #  #        #        #  #  #  #  #     #  #     #  #
#  #######  ####  ####  ####  ####  ##########  #######  #  #############  #  ####  ##########  #  #  #######  #  #  ####  #  #  #  #  #  #######  #  #
#  #        #  #     #  #  #  #  #        #  #  #  #        #     #     #  #  #        #     #  #        #  #     #     #        #     #        #     #
#  #######  #  #  #  ####  ####  #  #  ####  #  #  #######  #  ####  ####  #######  #######  ####  ####  #  ##########  ####  #  #######  ####  #  ####
#     #  #     #  #  #     #  #     #     #  #        #                 #        #  #     #  #  #  #                 #  #     #     #     #  #  #     #
#  ####  ################  #  #  ####  ####  ##########  ################  #######  ####  #  #  ####  #######  ####  #  #  ####  #  #######  #  #  #  #
#           #  #  #  #     #     #  #  #                    #           #        #  #  #  #     #     #  #        #           #  #     #     #  #  #  #
#  #######  #  #  #  ####  ####  #  #  #  #######  #  #  ####  ####  #  #############  #  #  ##########  #  ##########  #######  #  #  ####  ####  ####
#  #              #        #        #  #  #        #  #  #  #     #  #     #     #        #  #  #  #     #     #           #  #  #  #  #     #        #
####  #  #######  #  ##########  #  #######  #######  ####  #######  ##########  #  #######  #  #  #  #  ##########  ####  #  ####  ####  #############
#     #  #  #              #  #  #  #     #        #  #                 #     #        #  #     #  #  #        #     #           #  #           #  #  #
#  ####  #  ################  #  #  #  #  #######  #######  ##########  #  ##########  #  #  #  #  #  ##########  #  ####  #######  #  ##########  #  #
#     #  #     #        #     #  #     #  #                 #        #     #  #  #           #  #        #  #  #  #     #        #        #  #     #  #
#  ####  #  #  ####  ####  #  #######  ####  #######  ####  ####  ##########  #  #  #######  ####  #######  #  ####  ##########  #######  #  #  ####  #
#  #        #              #  #           #     #        #                          #           #                       #           #                E#
#######################################################################################################################################################
