####################################################################################################
#                                                                                                  #
#                                                                                                  #
#                                                                                                  #
#                                                                                                  #
#                                                                                                  #
#                                                                                                  #
#                                                                                                  #
#                                                                                                  #
#                                                                                                  #
#                                          S                                                       #
#                                                                                                  #
#                                                                                                  #
#                                                                                                  #
#                                                                                                  #
#                                                                                                  #
#                                                                                                  #
#                                                                                                  #
#                                                                                                  #
#                                                                                                  #
#                                                                                                  #
#                                                                                                  #
#                                                                                                  #
#                                                                                                  #
#                                                                                                  #
#                                                                                                  #
#                                                                                                  #
#                                                                                                  #
#                                                                                                  #
#                                                                                                  #
#                                                                                                  #
#                                                                                                  #
#                                                                                                  #
#                                                                                                  #
#                                                                                                  #
#                                                                                                  #
#                                                                                                  #
#                                                                                                  #
#                                                                                                  #
#                                                                                                  #
#                                                                                                  #
#                                                                                                  #
#                                                                                                  #
#                                                                                                  #
#                                                                                                  #
#                                                                                                  #
#                                                                                                  #
#                                                                                                  #
#                                                                                                  #
#                                                                                                  #
#                                                                                                  #
#                                                                                                  #
#                                                                                                  #
#                                                                                                  #
#                                                                                                  #
#                                                                                                  #
#                                                                                                 E#
####################################################################################################