#######################################################################################################################################################
#                 #        #     #           #  #     #     #        #  #     #  #  #     #  #              #  #           #  #        #           #  #
S  #  #######  ####  #  #  #  ####  ####  #  #  #  ####  #  #  #######  #  ####  #  ####  #  #  #  #  ####  #  ####  #######  #  ####  #  ####  #  #  #
#  #        #  #     #  #     #     #  #  #  #     #     #                                #     #  #  #  #  #  #           #     #     #     #  #     #
####  #######  ####  #  #######  ####  ####  ####  #############  ###################  #  #######  #  #  #  #  #  #  #############  ####  #############
#     #     #  #     #  #                 #           #        #                    #  #  #     #  #  #     #     #     #     #        #     #     #  #
#  #  #  ####  #  ####  ####  #######  ##########  ####  ####  #  #  #############  #  #######  ####  ####  #  #######  #  #######  ####  #  #  #  #  #
#  #     #        #        #  #  #     #                 #  #     #              #  #  #        #     #  #        #  #  #  #        #     #  #  #  #  #
#############  ####  #  ####  #  #  #  #  ####  ##########  ############################  #############  ####  ####  ####  #######  #  ##########  #  #
#           #     #  #        #     #  #  #     #  #        #  #     #                                   #  #  #        #  #           #     #        #
####  #######  #  #  ################  #  #  #  #  #######  #  ####  #  ##########  ################  #  #  #  #######  #  #  ####  ####  ####  #######
#        #     #  #           #  #     #  #  #     #  #           #  #     #     #              #     #  #  #     #     #  #     #  #  #  #           #
#  ####  #  #######  #######  #  #  ####  ####  #  #  #  #  #######  ####  #  #######  #  #######  #  ####  ####  ####  #  #  #######  #  #  ##########
#  #        #  #  #  #     #  #  #  #  #  #     #        #        #  #              #  #     #     #        #                                #  #     #
####  ####  #  #  ####  #######  #  #  #  #  #  #######  ##########  #  ####  ######################  #######  #############  #############  #  #  #  #
#  #  #  #  #        #     #  #  #     #  #  #     #  #     #           #  #     #        #     #           #  #     #     #  #        #  #  #     #  #
#  #  #  ##########  #  #  #  #  #  ####  ##########  ##########  #  #  #  #  ####  #######  #######  ##########  #  ####  #  ####  ####  #######  #  #
#           #     #     #        #  #  #     #              #     #  #  #     #           #     #  #  #           #  #     #           #  #  #     #  #
####  #######  #  #  #############  #  ####  #  ####  #######  ####  #  #  #  ####  #  ####  #  #  ####  ##########  ####  #######  ####  #  #  #######
#     #  #  #  #  #        #        #     #        #  #     #     #  #  #  #  #     #        #  #     #  #        #     #           #                 #
#  #  #  #  #  ####  #  ####  ####  #  #  #  #  #######  #######  ####  #  #############  #######  #  #######  #  #  #  ##########  #  #############  #
#  #  #           #  #  #  #  #        #  #  #  #  #        #     #  #  #     #  #              #  #        #  #  #  #  #              #        #  #  #
####  #  #######  #  ####  #  #  #  ####  #  ####  #  #  ##########  #######  #  #############  #  #############  ####  #######  ####  #######  #  #  #
#     #        #     #        #  #  #     #  #  #     #  #     #        #  #     #           #  #           #  #                    #     #  #  #     #
#  #  #  ####  ####  #######  ##########  ####  #  #  #  #  ##########  #  #  #  ##########  #  ####  ####  #  #############  #  ##########  #  ####  #
#  #     #  #  #  #  #  #  #  #                 #  #  #     #        #     #  #  #     #  #           #        #              #              #        #
#  #######  ####  #  #  #  ################  ####  #######  ####  #  ####  #  ####  ####  #############  #  #######  ####  #  #  #  ##########  ####  #
#  #     #  #        #     #  #              #           #     #  #  #        #     #        #           #     #        #  #  #  #           #  #     #
#  #  ####  #  #  ####  #  #  #############  ####  #  ####  #######  #######  #  #  #######  #######  #  #  ####  ####  #######  ##########  #######  #
#  #     #  #  #  #  #  #  #  #  #  #              #  #        #              #  #  #     #     #  #  #  #     #  #  #  #        #  #              #  #
#  ####  #  #  #  #  ####  #  #  #  ####  #  ####  #######  ##########  #  ####  #  ####  #  #  #  ##########  #  #  #######  ####  #  ####  ####  ####
#  #        #  #  #  #  #           #     #     #  #  #  #              #     #  #  #        #           #  #     #  #     #        #  #  #     #     #
#  #  #  #  #######  #  #######  #######  #######  #  #  #  ##########  ##########  ####  #  #############  #  ####  #  #  #######  ####  #############
#     #  #  #     #        #  #     #        #           #           #  #              #  #  #     #     #  #  #  #  #  #     #           #  #        #
####  #  #######  #  #######  ####  ##########  #  ##########  #######  ####  #  ####  #  #######  #  ####  #  #  #  #######  #  #######  #  #  #  #  #
#  #  #                 #  #  #     #        #  #  #  #     #  #              #  #  #     #     #           #     #     #              #  #     #  #  #
#  ####  ####  #  #######  #  #  #  #  #  #  #  ####  ####  ##########  ##########  ####  #  #  #  #############  #  ####  ####  #  #  #############  #
#  #  #  #     #  #        #  #  #     #  #     #        #           #  #     #     #  #  #  #  #  #           #  #     #  #  #  #  #                 #
#  #  ####  #############  #  #  #######  ####  #  #######  ####  ####  ####  #  #  #  #  ####  #  ####  ####  ####  ####  #  #############  ####  #  #
#                    #  #     #  #           #           #  #     #  #     #     #        #        #  #  #     #     #     #        #        #     #  #
#  #  #  ####  #  ####  ####  #  #######  #  #######  #######  ####  ####  ##########  #  #######  #  #  #  ####  ####  #  ####  ####  #  #  #######  #
#  #  #     #  #     #  #     #        #  #        #              #           #        #                 #  #        #  #        #     #  #  #  #  #  #
####  ####  ####  #  #  #  ################  ################  ########################################  ##########  #  #######  ####  ####  #  #  ####
#     #     #     #  #           #        #           #     #     #     #     #        #     #              #           #  #        #     #           #
#  ####  ####  #  #######  #######  #  #  ####  ##########  #######  ####  #  #  #######  #############  #  #############  #  ####  #  ####  #######  #
#     #  #     #           #        #  #        #  #     #           #  #  #     #  #  #  #     #  #     #           #     #  #     #  #           #  #
####  ####  ####  ####  #############  #  ####  #  #  #  #  ####  ####  #  #  #  #  #  #  ####  #  #  ####  #  #  #######  #  ##########  ####  ####  #
#     #        #  #  #  #        #  #  #  #     #     #        #           #  #  #  #  #                 #  #  #           #  #  #        #        #  #
#############  #  #  #######  ####  #######  ####  ###################  ##########  #  #  #######  #######  #  #  #  ##########  ####  ##########  ####
#        #     #  #        #     #     #                 #  #           #     #     #     #        #     #  #  #  #                 #  #     #  #  #  #
#  #  #  #  #  ####  #######  #  #  #######  #  #  #  #  #  ####  #######  ####  ####  #  #######  #  #  #  ##########  ####  #  #  #######  #  #  #  #
#  #  #  #  #  #  #  #  #     #        #     #  #  #  #  #     #  #  #        #     #  #  #     #     #  #        #  #  #  #  #  #     #              #
#  #  ####  ####  #  #  ####  #  ################  #######  #  ####  #######  #  ##########  #  #  ##########  ####  #  #  #  ##########  #######  ####
#  #     #  #        #  #     #              #           #  #  #     #     #  #  #     #  #  #     #        #  #     #     #           #     #        #
####  #  #  #######  #  ####  #  #######  #######  #  #######  ####  #  ####  #  #  #  #  #######  #  #############  ################  ##########  #  #
#  #  #        #  #           #  #        #  #  #  #  #     #              #        #           #  #     #  #  #  #     #     #     #  #  #        #  #
#  #############  ##########  ####  ####  #  #  #  ####  ##########  #  ##########  #############  ####  #  #  #  #  #######  #  #  #  #  ####  #######
#                             #  #  #        #     #        #     #  #        #  #        #  #  #           #        #  #        #              #  #  #
####  #  #  #######  #  ####  #  #  ####  ####  #######  ####  ####  ##########  #  #######  #  #######  ##########  #  #######  ####  #  #  #  #  #  #
#     #  #  #        #  #        #  #     #  #     #        #  #     #                 #        #        #  #  #        #        #     #  #  #        #
#  ##########  #  #  #  ####  #######  ####  ####  ####  ####  #  ####  #  #  ####  ####  #######  #  #  #  #  ####  #  ################  #  ####  #  #
#  #     #  #  #  #  #  #        #     #     #     #           #  #     #  #     #  #     #        #  #        #  #  #  #                 #  #  #  #  #
#######  #  ####  #######  #  #############  ####  ####  #  ####  ##########  ##########  ####  ####  ##########  ####  #  #######  ##########  ####  #
#        #  #        #  #  #     #        #  #        #  #        #                 #              #  #  #        #  #        #                    #  #
#  #  #  #  #  ####  #  ##########  #  ####  ####  ##########  #  #######  #  #  #######  ####  #######  #######  #  #  #  #  #  #  ####  ####  #  ####
#  #  #     #  #  #                 #        #  #              #     #     #  #  #  #  #     #  #     #  #        #     #  #  #  #     #  #  #  #     #
#  #  ####  #  #  ####  #  #  #  #  #  ####  #  #  #  ####  #######  ##########  #  #  ####  ####  ####  #######  ####  ####  ####  #  ####  #  ####  #
#  #     #  #  #        #  #  #  #  #  #  #     #  #     #  #     #  #  #     #  #  #  #     #     #     #           #  #  #  #  #  #  #     #  #  #  #
#  #  #############  ####  #######  ####  #############  ####  #######  ####  #  #  #  #  #  ####  ####  #######  ####  #  ####  #######  #  ####  #  #
#  #  #  #     #  #     #  #              #  #        #  #              #  #     #        #        #              #        #     #        #     #  #  #
#  #  #  #  #  #  #  #  #######  ####  #  #  #######  ##########  #  ####  #  #  #  ##########  #  #######  #  ##########  #  #  ####  #  #######  #  #
#  #  #  #  #     #  #     #  #  #  #  #  #  #              #  #  #  #        #     #     #     #     #  #  #              #  #  #  #  #  #     #     #
####  #  ####  ####  #######  ####  ####  #  #  #  ##########  ####  ####  #  ####  #  #  #######  ####  #  #######  #######  ####  #  #  #  ####  #  #
#     #              #        #     #           #        #     #     #     #     #  #  #     #        #  #     #     #     #     #  #  #  #  #     #  #
####  #######  ##########  ####  ##########  ##########  #  #######  ####  #  #############  #  ####  #  #######  ####  ####  ####  #  #  #  #  #######
#  #           #  #     #  #              #           #           #        #  #     #           #  #  #  #     #     #  #  #        #  #     #     #  #
#  ####  #  #  #  #  ####  ####  ####  #  ####  ####  ##########  #  ####  ####  #  #  #######  #  ####  ####  ####  #  #  #  ####  #  #  ####  ####  #
#        #  #           #     #     #  #     #  #     #  #              #  #  #  #  #     #           #     #  #           #  #        #     #        #
##########  ##########  #  ####  #  ####  #############  ####  #  ##########  #  ##########  #  #  ####  ####  #######  ####  ##########  ####  ####  #
#           #        #        #  #  #        #           #  #  #     #           #     #     #  #  #  #        #     #  #     #     #  #  #  #     #  #
#  #######  #######  #  #  ##########  #  ##########  ####  #######  #######  #  #  ####  #  #######  #  ####  #  ##########  #  #  #  #  #  #  #  ####
#  #  #        #        #  #  #        #     #     #     #        #  #        #     #     #     #  #        #  #        #        #  #  #        #     #
#  #  #  ################  #  #  #  ##########  ####  ####  ##########  #  ####  #######  #  ####  #  #############  ##########  ####  ####  ####  #  #
#  #        #     #     #     #  #           #              #        #  #     #     #     #     #        #  #  #  #              #  #     #     #  #  #
#  #  #  ####  ####  ####  #######  ####  #######  #  #######  #######  #######  #  #  ##########  #  ####  #  #  #######  ####  #  ####  ##########  #
#  #  #     #  #  #     #  #           #  #     #  #                       #  #  #     #        #  #              #  #        #     #        #  #     #
#  ##########  #  #  #  #############  #######  ##########  #######  #######  ####  ####  ##########  ####  ####  #  #  #######  ##########  #  #######
#  #        #     #  #     #  #  #           #  #        #     #  #              #     #              #        #  #           #              #        #
#  ####  #######  #  #  #  #  #  ##########  #  #  ##########  #  #######  ####  #  #######  #  #############  ######################  #  #  #  #  ####
#              #  #  #  #  #              #           #           #           #  #           #  #  #     #  #  #     #  #              #  #  #  #  #  #
#  ####  #  #  #  #######  #  ##########  #######  ####  ####  ###################  #############  #  ####  #  #  #  #  #  #######  ####  #######  #  #
#     #  #  #  #              #  #                       #              #        #     #  #  #        #     #  #  #  #  #  #        #                 #
#  ##########  ####  #######  #  #######  #######  ####  #######  #  ####  #  #  ####  #  #  ####  #  #  #  #  #  ####  #######  #  ####  #  #######  #
#     #     #     #  #           #     #  #        #           #  #  #  #  #  #     #  #  #  #  #  #     #  #  #        #        #  #     #  #  #     #
#  ####  ####  #######  #######  #  #  ####  #  #######  #############  ####  #######  #  #  #  #  #  #######  #######  #######  #######  #  #  ####  #
#     #  #        #  #     #  #  #  #     #  #  #           #     #  #                    #        #     #  #  #        #  #  #  #  #  #  #  #  #     #
#  #  #  #  #######  ####  #  #  #  #############  #######  #  ####  ####  #  #  ####  ##########  #######  ####  #  ####  #  #  #  #  ####  #  #  #  #
#  #     #  #  #     #  #  #     #        #        #     #     #  #     #  #  #     #                    #     #  #     #           #     #  #     #  #
#######  #  #  ####  #  ####  #######  #  #######  #  ####  #  #  #  ####  #######  #  ##########  ####  #  #  ####  #######  #######  ##########  ####
#        #     #                 #     #              #     #  #              #     #  #              #     #        #                    #          E#
#######################################################################################################################################################