##########
#      # #
## ### # #
## #     #
S  # # # #
# ## ### #
#    # # #
#### # # #
#      #E#
##########